13131313131313133333333333333D
31313131313131333333333333333D
34343434343434333333333333333D
33333333333333333333333333333D
11111111111111133333333333333D
55555555555555533333333333333D
22222222222222233333333333333D
9999999999A999933333333333333D
BBABBBBBBBBBBBB33333333333333D
999999A9999999933333333333333D
22222222222222233333333333333D
22222222222222233333333333333D
DDEDDDDDDDDFEDD33333333333333D
EEDEEFEEEEEEEEE33333333333333D
FFEFDFFFFFFFEFF33333333333333D
13131313131313133333333333333D
31313131313131333333333333333D
34343434343434333333333333333D
33333333333333333333333333333D
11111111111111133333333333333D
55555555555555533333333333333D
22222222222222233333333333333D
9999999999A999933333333333333D
BBABBBBBBBBBBBB33333333333333D
999999A9999999933333333333333D
22222222222222233333333333333D
22222222222222233333333333333D
DDEDDDDDDDDFEDD33333333333333D
EEDEEFEEEEEEEEE33333333333333D
FFEFDFFFFFFFEFF33333333333333D
