131313131313131
313131313131313
343434343434343
333333333333333
111111111111111
555555555555555
222222222222222
9999999999A9999
BBABBBBBBBBBBBB
999999A99999999
222222222222222
222222222222222
DDEDDDDDDDDFEDD
EEDEEFEEEEEEEEE
FFEFDFFFFFFFEFF
