111111151111111
111111151111111
222222252222222
232323252323232
323232353232323
333333353333333
344444454444443
344444454444443
377777767777773
344444444444443
344444444444443
222222222222222
111111111111111
111111111111111
111111111111111
