0000000000000000
011111CCC1111111
011111CCC1111111
0111117C71111111
0114444C55511111
0114444C55511111
0CCCCCCCCCCCCCCC
0CC666C666666CCC
0CC666C666666CCC
011111C111121111
011111C19AB21111
011111C1DEF21111
011111C122221133
01111CCC28221133
01111CCC22221133
0111111111111133
