0000000000000000
011111CCC1111111
011111CCC1111111
0111117C71111111
0114444C55511111
0114444C55511111
0CCCCCCCCCCCCCC1
0CC666C666666CC1
0CC666C666666CC1
011111C111121111
011111C19AB21111
011111C1DEF21111
011111C111222331
011111CCC1282331
011111CCC1222331
0111111111111111
