111111CCC1111111
111111CCC1111111
111111CCC1111111
1111117C71111111
1114444C55511111
1114444C55511111
CCCCCCCCCCCCCCCC
CCC666C666666CCC
CCC666C666666CCC
111111C111121111
111111C19AB21111
111111C1DEF21111
111111C111222333
111111CCC1282333
111111CCC1222333
111111CCC1233333
