0000000000000000
011111CCC1111110
011111CCC1111110
0111117C71111110
0114444C55511110
0114444C55511110
0CCCCCCCCCCCCCC0
0CC666C666666CC0
0CC666C666666CC0
011111C111121110
011111C19AB21110
011111C1DEF21110
011111C111222330
011111CCC1282330
011111CCC1222330
0000000000000000
