1111111C11111111
1111111C11111111
1111111C11111111
1111117C11111111
1114444C55511111
1114444C55511111
CCCCCCCCCCCCCCCC
111666C666111111
111666C666111111
111111C111111111
111111C9AB111111
111111CDEF111111
111111C111222111
111111CCC1282111
111111CCC1222111
111111CCC1111111
