1111111111111111
111111CCC1111111
111111CCC1111111
1111117C71111111
1114444C55511111
1114444C55511111
1CCCCCCCCCCCCCC1
1CC666C666666CC1
1CC666C666666CC1
111111C111121111
111111C19AB21111
111111C1DEF21111
111111C111222331
111111CCC1282331
111111CCC1222331
1111111111111111
