1111111111112222
11111111111122C2
1111111111112222
3333333231112222
1111111111112333
11111145111123C3
1111118922222333
1111112222111111
1111112672111111
1111112AB2111111
3333312222131111
11111112111C3333
1111111211111111
1222111213336711
13C311111112AB11
1111111111111111
