1111111111111111
1111111111112221
1111111111112221
1333333231112221
1111111111112331
11111145111123C1
1111118922222331
1111112222111111
1111112672111111
1111112AB2111111
1333312222131111
11111112111C3331
1111111211111111
1222111213336711
13C311111112AB11
1111111111111111
