1111111111111111
11111111111112C1
1111111111111221
1113333332311111
1111111111111111
1111114511111111
1111118911111111
1111112222111111
1111112672111111
1111112AB2111111
3333312222131111
11111112111C3333
1111111211111111
1222111213336711
13C311111112AB11
1111111111111111
