0111111111111111
0111111111112221
0111111111112221
0333333231112221
0111111111112331
01111145111123C1
0111118922222331
0111112222111111
0111112672111111
0111112AB2111111
0333312222131111
01111112111C3331
0111111211111111
0222111213336711
03C311121112AB11
0000000000000000
