0000000000000000
0111111111112220
0111111111112220
0333333231112220
0111111111112330
01111145111123C0
0111118922222330
0111112222111110
0111112672111110
0111112AB2111110
0333312222131110
01111112111C3330
0111111211111110
0222111213336710
03C311111112AB10
0000000000000000
