0000000000000000
1122851111111110
1122851111111110
1122531111111110
1122881111111110
1122531111111110
1122881111111110
1122531111111110
1122881111111110
112253EF11EF1110
1122838353835380
1122585858585850
1122222222222220
1122222222222220
1111111111111110
1111111111111110
