0000000000000000
1122885222224430
1122858111116740
112258811111AB40
1122855119111440
112258411D111440
1122854144111340
1122584114111340
1122854114111330
11225844141EF330
1122858585111330
1122585858588330
1122588558855330
1122555855585330
1111111111111110
1111111111111110
