0000000000000000
0222144444444440
0232644444644440
0222144464464440
0891144544444440
0CD16445FF554440
01111445EF544440
0444664444564440
0444444477544440
0464445555544440
044444444A5B4440
0444555555554440
0444777777774440
0444444444444440
0444444444444440
0000000000000000
