1111144444444440
1222144444444440
1232844444944440
12221444C44D4440
1111144544444440
11116445FF554440
11111445EF544440
4444664444584440
4444444477544440
4464445555544440
444444444A5B4440
4444555555554440
4444777777774440
4444444444444440
4444444444444440
0000000000000000
