1111144444444444
1222144444444444
1232644444644444
1222144464464444
1891144544444444
1CD16445FF554444
11111445EF544444
4444664444564444
4444444477544444
4464445555544444
444444444A5B4444
4444555555554444
4444777777774444
4444444444444444
4444444444444444
4444444444444444
